NO ./sprites/bob.xpm
        SO                                 ./sprites/patoche.xpm               
WE ./sprites/carlo.xpm       
 F          10,25,100                                                                                                         
  

 C        50,100,00
EA ./sprites/krab.xpm







111111111111111111111111111111111111111111111111111111111111111111111111111111111111
110000000000000000000000000000000000000000000000000000000000000000000000111111111111
110000000000000000000000000000011111111111111000000000000000000000000000000011111111
110000000000000000000000000011111111111111111111000000000000000000000000000011111111
110000000000000000000000000000000000011111111111100000000000000000000000000011111111
110000000000000000000000001111111111111111111111100000000000000000000000000011111111
110000000000000000000000001111111111111111111111100000000000000000000000000011111111
110000000000000000000000000000000000000000001111100000000000000000000000000011111111
110000000000000000000000000011111111111111111111000000000000000000000000000011111111
110000000000000000000000000000011111111111111000000000000000000000000000000011111111
110000000000000000000000000000001111111111110000000000000000000000000000000011111111
110000000000000000000000000000001111111111110000000000000000000000000000000011111111
1100000000000000000000000000000000000000000000000000000000000000000000000000011111111
110000000000000000000000000000001111111111110000000000000000000000000000000011111111
110000000000000000000000000000001111111111110000000000000000000000000000000011111111
110000000000000000000000000000001111111111110000000000000000000000000000000011111111
110000000000000000000000000000001111111111110000000000000000000000000000000011111111
11000000000000N000000000000000001111111111110000000000000000000000000000000011111111
110000000000000000000000000000001111111111110000000000000000000000000000000011111111
110000000000000000000000000000001111111111110000000000000000000000000000000011111111
110000000000000000000001111111111111111111111111111111111111111111111111111111111111
111111111111111111111111111111111111111111111111111111111111111111111111111111111111


